WWWWWWWWWWWWWWWWWWWWWWWWWWWWWWWWWWWWWWWW
W                                      W
WX                                     W
WW                                     W
W                                     WW
W                                  W   W
W                    H                 W
W                                      W
W                               W      W
W                                      W
W                                      W
W          W                           W
W                            W         W
W                                      W
W                                      W
W                                      W
W                                      W
W                         W            W
W                         W     S      W
W                         WWWWWWWWWWWWWW
W                                      W
W                                      W
W                                      W
WP                                     W
WPPP    P                              W
WPPPP PPPP                             W
WPPPPPPPPPPP               F           W
WPPPPPPPPPPPPPP            WWWW        W
WPPPPPPPPPPPPPPPP                      W
WPPPPPPPPPPPPPPPPPPPP     S            W
WPPPPPPPPPPPPPPPPPPPPPP                W
WWWWWWWWWWWWWWWWWWWWWWWWWWWWWWWWWWWWWWWW